.............
...........#.
.#...###...#.
.#...###...#.
.#...###...#.
.#...###...#.
.#.........#.
.#...........
.............
.............