.............
...#.....#...
....#...#....
...#######...
..##.###.##..
.###########.
.#.#######.#.
.#.#.....#.#.
....##.##....
.............